5555555555555555555555555555
5000004400000000000044000005
5000004400000000000044000005
5000004400000000000044000005
5000000000000000000000000005
5000000000000000000000000005
5111000005522222255000001115
5000004444444444444444000005
5000000444444444444440000005
5000004444444444444444000005
5000010000011001100000100005
5000555000111001110005550005
5000000001111111111000000005
5000000011100000011100000005
5110000111000000001110000115
5000001000000000000001000005
5000011000000000000001100005
5000111001110000111001110005
5000110000000000000000110005
5000100000000000000000010005
5000111000000000000001110005
5000000011111111111100000005
5110000014444444444100000115
5000000014411111144100000005
5000000014419000144100000005
5000100000010000144100010005
5000100000010000144100010005
5555555555555555555555555555