5555555555555555555555555555
5000000000011000000000000005
5000000000011000000000000005
5000050050011110000000500005
5000050050000000000000000005
5110000050110000000550000005
5000000111115511111110005555
5000011111111111111110000445
5442211114444444444111100445
5442211144444444444411122445
5000001441111111111441122445
5000001441111111111441144445
5000011441141111411441144445
5000011441111111111441144445
5000011441111411111441144445
5200011441411441141441100115
5110011441441111441441100115
5000011441144444411441100005
5000011441111111111441100005
5000011144444444444411100005
5000011114444444444111111005
5000011111111111111111111005
5000000000000000044444444445
5000000000011111144444444445
5000000000019000100000044555
5110000000010000100000044115
5110010000010000100000044115
5555555555555555555555555555