5555555555555555555555555555
5000000000000000000000000005
5000000000001000100000000005
5000110000001000100000110005
5001111000011000110001111005
5000110000001111100000110005
5000000000005555500000000005
5000110001000000001000000005
5000000001000000001001100005
5000000001100000010001100005
5000220054444444444500000005
5000110045444444445400111005
5000110044544444454400110005
5000111144454444544400110005
5000111144445445444401110005
5115222244444444444422225115
5115222244444444444422225115
5000000044445445444400000005
5000010044454444544400100005
5000010044544444454400100005
5000000045444444445400000005
5000000054444444444500000005
5110000000000110000000000115
5100000000011111100000000015
5100000000019000100000000015
5000044000010000100004400005
5000000000010000100000000005
5555555555555555555555555555