5555555555555555555555555555
5000500000500000000500000005
5000000000000000000000000005
5000000000000000000000000005
5544411222222222000000000005
5444444110000110000000000005
5444444110000110000000000005
5444444220001552222211222225
5444444220001552222211222225
5555111220000000000000110005
5000111220000000000000110005
5000000220000000000000110005
5000000000000000000000220005
5000000000000114400000220005
5000000000000114400222220005
5112222442222222211222220005
5112222442222222211221100055
5000221444444220000221100005
5000221444444220000221100005
5000221444444220000221100005
5000221444444224440111100005
5005551001111000440111100115
5005551000000000000002211005
5000110000011111100002200115
5000110000019000100002211005
5000221100010000100001100115
5000221100010000100001100005
5555555555555555555555555555